49,16,33,18,27,6,6,6,6,6,,,,,,,,,,,
46,16,27,,,6,,16,25,6,,,,,,,,,,,
40,16,24,6,6,6,,16,31,6,,,,,,,,,,,
,,,6,40,16,,6,6,6,,,,,,,,,,,
6,6,6,6,,6,,6,6,6,6,,,,,,,,,,6
6,,,,,,,,,,6,,,,,,,,,,
6,,,,,,,,,,6,,,,,,,,,,
6,,,,,,,,,,6,,,,,,,,,,
6,41,16,26,,,,40,,,6,6,6,6,6,,,,,,
6,,,,,,,16,,,6,,,,6,,,,,,
6,,,,,,,32,,,9,,54,,6,,,,,,
6,,,,,,,,,,6,,,,6,,,,,,
6,,1,,0,,14,,,,6,6,6,6,6,,,,,,
6,,,,,,,,,,6,,,,,,,,,,
6,,,,,,,,,,6,,,,,,,,,,
6,6,6,6,6,6,6,6,6,6,6,,,,,,,,,,
